142	142	 96  95  94	 94  95  96 142	142
141	141	 92	 91  90  90	 91  92	141	141
140	140	 88	 87	 86	 86	 87	 88	140	140
139	139	 85	 84	 83  83	 84	 85	139	139
138	138	 82	 81	 80	 80	 81	 82	138	138
137	137	 79	 78	 77	 77	 78	 79	137	137
136	136	 66  65	 64	 64	 65	 66	136	136
135	135	 63	 62	 61	 61	 62	 63	135	135
134	134	134	 60  59	 59	 60	134	134	134
133	133	133	 58	 57	 57	 58	133	133	133
132	132	132	 56	 55	 55	 56	132	132	132
131	131	131	 54	 53	 53	 54	131	131	131
130	130	130	 52	 51	 51	 52	130	130	130
124	124	124 124	 46	 46	124	124	124	124
123	123	123 123	 41	 41	123	123	123	123
122	122	122 122	 36	 36	122	122	122	122
121	121	121 121	 31	 31	121	121	121	121
120	120	120 120	 26	 26	120	120	120	120
119	119	119 119	 21	 21	119	119	119	119
118	118	118 118	 16	 16	118	118 118	118
117	117	117 117	 11	 11	117	117	117	117
114	114	114 114	  6	  6	114	114	114	114
110	110	110 110	  1	  1	110	110 110	110